11111111111011
01111111111111
11111111111111
11111111111111
11111111111111
111111y1111111
11111111111111
11111111111111
11111111111111
11110000001111
11110111111x11
11111111111111
11111111111110
11110111111111