11111111111111
11111111111111
00111111001y11
00111111101111
11110111111111
11110111111111
11110111111111
11100111111111
11111111110011
11x11111111001
11110000111111
11111111111111
11111111111111
11011111111110