11111111111111
11111111111111
111111111y1101
11100110011001
11100110011001
11111111111111
11111x11111111
11100110011111
11100110011111
11111111111001
11100110011001
11100111111111
11111111111100
11111111111100