11111111111101
11111111111111
11111111111111
10111y10011111
10110000111111
10111111110111
11111111110011
11111111110011
1111x111111111
11111111110011
10011111111111
10011111111111
11011111111111
11111111111110