11111111111111
11111111111111
111111111111y1
11111001111111
11111101111111
01111111111111
01111111111111
01111111111111
11111110011111
11111111011111
10000111111111
11101111111111
11111111011110
x1111111011111