0111111111111x
01111110111111
01111110111111
111111101y1111
11111110111111
11101111111111
11101110111011
11101111111111
11111111111111
11111011111110
11111011111111
11111111111111
11111111111111
11111111111111